6 6
####
#  ###
#  $@#
# *. #
##   #
 #####