11 8
     #
    ###
  ## @ ##
 # . * . #
# $.$*$.$ #
#  ## ##  #
#         #
###########