8 9
  ####
###  #
#    #
#   .###
### #@.#
  # $$ #
  #  $ #
  #. ###
  ####