8 6
 #######
## .   #
# $*$# #
# #@   #
#  . ###
######