19 17
##################
#   ####  ####   #
#   @     #    # ##
## #####    #     #
##       #    #   #
#  #### ####  # ###
#    #     #### ###
# ##     #        #
#    # # # #   #  #
## # #   #    #.  #
 #      #   #    ##
 #    #   # #  #  #
## #####     #    #
#      # # #    # #
#  #$#        # # #
#  #    #  #  #   #
###################