8 8
 ####
 #  #
 #  ####
 # ..* #
## $$@ #
#   ####
#   #
#####