7 6
  #####
###   #
# $$$@#
#... ##
#    #
######