8 8
########
# .@.  #
# $ $  #
##*#*###
#     #
#     #
#  ####
####