8 8
 #######
 #    .#
 # ###.#
## #   #
#  # $ #
#  @ $##
#  #  #
#######