8 8
 #####
 # @ ###
 # #   #
##$.*# #
# $.*  #
# #  ###
#    #
######