7 7
 #####
##...##
# $$$.#
# $+$ #
#.$$$ #
##..  #
 ######