10 9
    #####
    #   #
##### # ##
#  # $   #
#   $  # #
# .. #   #
###@ #####
  #  #
  ####