8 8
 ######
##    #
# $## ##
#      #
##  .@.#
 #$# ###
 #   #
 #####