9 7
  #####
  #   ###
###@$.  #
#  *#   #
#   $. ##
#####  #
   #####