8 7
  #####
  #   #
###$# ##
#  $@$ #
# #    #
#... ###
######