9 7
####
#  #####
#    @ ##
# .*.$* #
##  #$  #
 ##   ###
  #####