7 7
#######
#. . .#
#   # #
##  $ #
 # $$##
 #  @#
 #####