9 8
########
#.. @..#
#  $$$ #
#### ####
#       #
#     $ #
#  ######
####