7 6
   ####
#### @#
#  $$ #
# . $ #
##.. ##
 #####