9 8
###
#.#####
#...  #
# # # ###
#   $$ @#
###  $$ #
  ###   #
    #####