18 15
  ################
 ##     #     #  #
 #  ### # ### #  #
 #               #
### ## #  # #  # #
#      #         #
# # # ########  ##
#       @ $  ##  #
## ## #### # .   #
 #    #  #   # ###
 ##       #    ##
 #  ### # # ##  #
 #  ##      ### #
 #     ####     #
 ################