9 7
  ####
###  ####
#    #@.#
#    $$.#
#  ## $.#
#####   #
    #####