11 12
 #####
 #   #
## # ####
#@      ###
#   # #   #
# # # $ # #
#   ##    #
# #    ####
#.  #   #
##### # #
    #   #
    #####