8 7
   #####
   #   #
####   #
#.*   ##
# $#  #
#@ #  #
#######