9 6
 #######
##....@##
#  $ #$ #
#  $  $ #
#  ##   #
#########