7 8
  ####
###  #
#    ##
# # ..#
# $$$@#
### # #
  #  .#
  #####