10 7
######
#    #
#  .$#####
##*+$    #
 # .$#   #
 ##  #####
  ####