9 8
#####
#   ###
#  .$ ###
## .# $ #
 # .# $@#
 ##.  $ #
  #  ####
  ####