7 8
  #####
 ##   #
 # @  #
## $ ##
# $* #
# #. #
#  .##
#####