6 7
#####
#   #
#.#$##
#  @ #
#. $ #
###  #
  ####