9 9
  ##
 #  #
 #$@#
 #.$##
##.$  ##
# .#   ##
#       #
#####   #
    #####