10 11
   ####
   #  #
   #  #
####  ####
#   # $@ #
#     $$.#
### ###  #
 ## .#####
 #   #
 #.  #
 #####