18 14
 ################
##  ##########  ##
#                #
#  ############  #
## ##  #  #   # ##
 # #      #   # #
 # #  ##  #  ## #
 # ## #   #  #  #
 #  # #      ## #
 # ## #  ##   # ##
## #  #########  #
# $#             #
#@ .#  #######  ##
#################