6 6
####
#  ###
# $  #
#@ . #
##   #
 #####